0,0,0,0,0,0,0,0,0,0,0,0,0,0,0,0,0,0,0,0,0,0,0,0
0,0,0,0,0,0,0,0,0,0,0,0,0,0,0,0,0,0,0,0,0,0,0,0
2,2,2,2,2,2,2,2,2,2,2,2,2,2,2,2,2,2,2,2,6,6,6,6
5,7,5,5,5,5,6,2,2,2,2,2,2,2,6,6,6,6,6,6,2,2,2,2
0,0,0,2,0,0,5,6,6,6,0,0,6,6,0,0,0,0,0,0,0,0,0,0
0,0,0,0,0,0,5,2,0,0,0,0,0,0,0,13,12,12,12,12,12,12,12,12
0,0,0,0,0,2,7,2,0,0,0,0,0,0,0,12,12,10,10,9,10,10,10,12
0,0,0,0,0,0,6,2,0,0,0,0,0,0,0,12,12,10,8,10,10,10,10,12
0,0,0,0,0,0,5,2,0,0,0,0,0,0,0,12,12,10,10,10,10,10,8,12
0,0,0,0,2,2,5,2,0,0,0,0,0,0,0,12,12,10,10,10,11,10,10,12
0,0,0,0,0,0,5,2,0,0,0,0,0,0,0,12,12,10,10,9,9,10,10,12
0,0,0,0,0,0,5,2,0,0,0,0,0,0,0,12,12,10,10,10,10,10,10,12
0,0,0,0,0,0,7,2,0,0,0,0,0,0,0,12,12,10,10,9,10,10,10,12
0,0,0,0,0,0,5,2,0,0,0,0,0,0,0,12,12,10,8,10,10,10,10,12
0,0,0,0,0,0,5,2,0,0,0,0,0,0,0,12,12,10,10,10,10,10,10,12
0,0,0,2,0,0,5,2,0,0,0,0,0,0,0,12,12,10,10,10,10,11,10,12
0,0,2,0,0,0,6,2,0,0,0,0,0,0,0,12,12,10,10,10,10,10,10,12
0,0,0,0,0,0,7,2,0,0,0,0,0,0,0,12,12,12,12,12,12,13,12,12
